anal	category=adjective
arse	strength=mild
arsing	category=adjective	strength=mild
ass	strength=mild
blasted	category=adjective	strength=mild
bloody	strength=mild
blooming	category=adjective	strength=mild
bollocks	strength=medium
bollox	strength=medium
bugger 	strength=mild
bullshit	strength=medium
butt	strength=mild
bum	strength=mild
cock	strength=strong
cocksucking	category=adjective strength=strong
crap	strength=mild
crappy	category=adjective	strength=mild
damn	strength=mild
dicksucking	category=adjective strength=strong
dozy	category=adjective	strength=mild
feck	strength=medium
fuck	strength=strong
fucking	category=adjective	strength=strong
fuckin	category=adjective	strength=strong
fucks	strength=strong
fucked	category=adjective	strength=strong
fucked up	category=adjective	strength=strong
goddam	strength=mild	
gormless	category=adjective
hell	strength=mild
humping	category=adjective strength=medium
mothafuckin	category=adjective	 strength=strong
mothafucking	category=adjective	 strength=strong
motherfucking	category=adjective	 strength=strong
munging	category=adjective	 strength=strong
minging	category=adjective	 strength=strong
naff	category=adjective	strength=mild
po-faced	category=adjective
poxy	category=adjective	
pussylicking	category=adjective strength=strong
screwed	category=adjective
shag	strength=medium
shit	strength=medium
shite	strength=medium
shittiest	category=adjective	strength=medium
shitting	category=adjective	strength=medium
shitty	category=adjective	strength=medium
skanky	category=adjective
