anal	category=adjective	type=sexist	original=sexual
anus	strength=mild	type=sexist	original=sexual
arse	strength=mild	type=sexist	original=sexual
arsing	category=adjective	strength=mild	type=sexist	original=sexual
ass	strength=mild	type=sexist	original=sexual
bitch ass	category=adjective	type=sexist	original=sexual
bitchass	category=adjective	type=sexist	original=sexual
blasted	category=adjective	strength=mild	type=general
bloody	strength=mild	type=general
blooming	category=adjective	strength=mild	type=general
bollocks	strength=medium	type=sexist	original=sexual
bollox	strength=medium	type=sexist	original=sexual
boner	type=sexist	original=sexual
boobies	type=sexist	origin=farrell
boobs	type=sexist	origin=farrell
boob	type=sexist
booner	type=racist	origin=farrell
boonga	type=racist	origin=farrell
boong	type=racist	origin=farrell
boonie	type=racist	origin=farrell
booobs	type=sexist	origin=farrell
boooobs	type=sexist	origin=farrell
booooobs	type=sexist	origin=farrell
booooooobs	type=sexist	origin=farrell
brain dead	category=adjective	type=reputation
braindead	category=adjective	type=reputation
bugger 	strength=mild	type=general
bullshit	strength=medium	type=general
bumblefuck	type=general
bum	strength=mild	type=sexist	original=sexual
butt	strength=mild	type=sexist	original=sexual
cock	strength=strong	type=sexist	original=sexual
cowardly	category=adjective	type=general
crappy	category=adjective	strength=mild
crap	strength=mild	type=general
cretinous	category=adjective	type=reputation
daft	type=reputation
damn	category=adjective	strength=mild	type=general
dick	type=sexist	original=sexual
dicks	type=sexist	original=sexual
dicksucking	category=adjective strength=strong	type=sexist	original=sexual
dirty	type=general
dozy	category=adjective	strength=mild	type=general
dumb	category=adjective	type=reputation
fat	type=general
f*ckin	category=adjective	type=general
f*cking	category=adjective	type=general
fcuk	type=general
fcuken	category=adjective	type=general
fcuking	category=adjective	type=general
feck	strength=medium
fken	category=adjective
f**kin	category=adjective	type=general
f**king	category=adjective	type=general
fool	type=reputation
friggin	category=adjective	type=general
frigging	category=adjective	type=general
fuc*ing	category=adjective	type=general
fucked	category=adjective	strength=strong	type=general
fucked up	category=adjective	strength=strong	type=general
fucken	category=adjective	type=general
fuckin	category=adjective	strength=strong	type=general
fucking	category=adjective	strength=strong	type=general
fucks	strength=strong	type=general
f u c k	strength=strong	type=general
fuck	strength=strong	type=general
fuc**ng	category=adjective	type=general
fu**in	category=adjective	type=general
fu**ing	category=adjective	type=general
fu*kin	category=adjective	type=general
fu*king	category=adjective	type=general
goddam	category=adjective	strength=mild	type=general
gormless	category=adjective	type=reputation
go to hell	type=general
humping	category=adjective	strength=medium
ignorant	category=adjective	type=reputation
minging	category=adjective	strength=strong	type=general
moronic	category=adjective	type=reputation
motha fuckin	category=adjective	type=general
mothafuckin	category=adjective	strength=strong	type=general
motha fucking	category=adjective	type=general
mothafucking	category=adjective	strength=strong	type=general
mother fcken	category=adjective	type=general
motherfcken	category=adjective	type=general
mother fucken	category=adjective	type=general
motherfucken	category=adjective	type=general
mother fuckin	category=adjective	type=general
motherfuckin	category=adjective	type=general
motherfucking	category=adjective	strength=strong	type=general
munging	category=adjective	strength=strong	type=general
pathetic	category=adjective	type=general
penis	type=sexist	original=sexual
phriggin	category=adjective	type=general
phrigging	category=adjective	type=general
phucken	category=adjective	type=general
phuckin	category=adjective	type=general
phucking	category=adjective	type=general
po-faced	category=adjective	type=general
poxy	category=adjective	type=general
prick	type=sexist	original=sexual
pricks	type=sexist	original=sexual
puke	type=general
shag	strength=medium	type=sexist	original=sexual
sheister	origin=farrell	type=general
shite	strength=medium	type=general
shit	strength=medium	type=general
shittiest	category=adjective	strength=medium	type=general
shitting	category=adjective	strength=medium	type=general
shitty	category=adjective	strength=medium	type=general
shut up	type=general
silly	type=general
snowflake	type=general
stupid	category=adjective	type=reputation
tits	plural=true	type=sexist
tit	strength=medium	type=sexist
titties	type=sexist	origin=farrell
tittie	type=sexist	origin=farrell
titty	type=sexist	origin=farrell
ugly	type=general
