bite me	origin=farrell	pos=youphrase
fuck off	strength=strongest	type=general
piss off	type=general
sod off	type=general
bugger off	type=general
bore off	type=general
fuck you	strength=strongest	pos=youphrase	type=general
fuck u	strength=strongest	pos=youphrase	type=general
FU	pos=youphrase	type=general
fuckyou	strength=strongest	pos=youphrase	type=general
get fucked	pos=youphrase	type=sexist	original=sexual
GFY	pos=youphrase	type=general
go fuck yourself	pos=youphrase	type=general
you are dumb	pos=youphrase	type=reputation
you are so dumb	pos=youphrase	type=reputation
u are dumb	pos=youphrase	type=reputation
u are so dumb	pos=youphrase	type=reputation
how dumb you are	pos=youphrase	type=reputation
how dumb u are	pos=youphrase	type=reputation
you are so stupid	pos=youphrase	type=reputation
how stupid you are	pos=youphrase	type=reputation
u are stupid	pos=youphrase	type=reputation
u are so stupid	pos=youphrase	type=reputation
how stupid u are	pos=youphrase	type=reputation
you are stupid	pos=youphrase	type=reputation
eat pussy	origin=farrell	pos=youphrase	type=sexist	original=sexual
go back to wherever you came from	type=racist	pos=youphrase
go back to where you came from	type=racist	pos=youphrase
go back wherever you came from	type=racist	pos=youphrase
go back where you came from	type=racist	pos=youphrase
go back to wherever u came from	type=racist	pos=youphrase
go back to where u came from	type=racist	pos=youphrase
go back wherever u came from	type=racist	pos=youphrase
go back where u came from	type=racist	pos=youphrase
shut the fuck up	pos=youphrase	type=general
shut da fuck up	pos=youphrase	type=general
shut your mouth	pos=youphrase	type=general
shut your fucking mouth	pos=youphrase	type=general
STFU	pos=youphrase	type=general
you cock	strength=strong	pos=youphrase	type=sexist	original=sexual	anatomy=male
u cock	strength=strong	pos=youphrase	type=sexist	original=sexual	anatomy=male
touch of the tar brush	type=racist	origin=farrell	pos=phrase
touch of the tar brushes	type=racist	origin=farrell	pos=phrase
dickless	origin=farrell	pos=phrase	anatomy=male	type=sexist	original=sexual
a cock	strength=strong	pos=phrase	type=sexist	original=sexual	anatomy=male
dick for brains	origin=farrell	pos=phrase	anatomy=male	type=reputation
a-hole	type=sexist	original=sexual
a-holes	plural=true	type=sexist	original=sexual
aunt jemima	type=racist	origin=farrell
aunt jemimas	type=racist	origin=farrell	plural=true
african forklift	type=racist	origin=farrell
alligator bait	type=racist	origin=farrell
bitch tits	type=sexist	anatomy=female
bitch-tits	type=sexist	anatomy=female
bitchtits	type=sexist	anatomy=female
black barbie	type=racist	origin=farrell
black barbies	type=racist	origin=farrell	plural=true
black dago	type=racist	origin=farrell
black dagos	type=racist	origin=farrell	plural=true
cheese eating surrender monkey	origin=farrell	type=racist
cheese eating surrender monkeys	origin=farrell	type=racist	plural=true
cheese eating surrender monkies	origin=farrell	type=racist	plural=true
cheese-eating surrender monkey	origin=farrell	type=racist
cheese-eating surrender monkeys	origin=farrell	type=racist	plural=true
cheese-eating surrender monkies	origin=farrell	type=racist	plural=true
cheese eating surrender-monkey	origin=farrell	type=racist
cheese eating surrender-monkeys	origin=farrell	type=racist	plural=true
cheese eating surrender-monkies	origin=farrell	type=racist	plural=true
cheese-eating surrender-monkey	origin=farrell	type=racist
cheese-eating surrender-monkeys	origin=farrell	type=racist	plural=true
cheese-eating surrender-monkies	origin=farrell	type=racist	plural=true
dumbshit	type=reputation
dumshit	type=reputation
dumbsh1t	type=reputation
dumsh1t	type=reputation
dumbsh!t	type=reputation
dumsh!t	type=reputation
dumbshits	plural=true	type=reputation
dumshits	plural=true	type=reputation
dumbsh1ts	plural=true	type=reputation
dumsh1ts	plural=true	type=reputation
dumbsh!ts	plural=true	type=reputation
dumsh!ts	plural=true	type=reputation
fanny flaps	origin=farrell	type=sexist	original=sexual	anatomy=female
fanny-flaps	origin=farrell	type=sexist	original=sexual	anatomy=female
fannyflaps	origin=farrell	type=sexist	original=sexual	anatomy=female
fresh off the boat	type=racist	origin=farrell
piece of feces	type=general
piece of faeces	type=general
piece of shit	type=general
piece of shite	type=general
piece of excrement	type=general
pieces of feces	plural=true	type=general
pieces of faeces	plural=true	type=general
pieces of shit	plural=true	type=general
pieces of shite	plural=true	type=general
pieces of excrement	plural=true
piss flaps	strength=strong	type=general
piss-flaps	strength=strong	type=general
pissflaps	strength=strong	type=general
poor white trash	type=racist	origin=farrell
pussy lips	type=sexist	origin=farrell	anatomy=women
pussy-lips	type=sexist	origin=farrell	anatomy=women
pussylips	type=sexist	origin=farrell	anatomy=women
redlegs	type=racist	origin=farrell
scum	type=general
shanty irish	type=racist	origin=farrell
son of a bitch	strength=medium	type=general
son-of-a-bitch	origin=farrell	type=general
sons of bitches	plural=true	type=general
sons-of-bitches	plural=true	type=general
sooties	plural=true	type=racist	origin=farrell
thick lips	type=racist	origin=farrell
twat lips	strength=strong	anatomy=female	type=sexist	original=sexual
thick-lips	type=racist	origin=farrell
twat-lips	strength=strong	anatomy=female	type=sexist	original=sexual
thicklips	type=racist	origin=farrell
twatlips	strength=strong	anatomy=female	type=sexist	original=sexual
whore from fife	origin=farrell	type=sexist
whores from fife	origin=farrell	plural=true	type=sexist
your arse	strength=mild	type=sexist	original=sexual
your ass	strength=mild	type=sexist	original=sexual
banjo lips	type=racist	origin=farrell
bans and cans	type=racist	origin=farrell
zogs	plural=true	type=racist	origin=farrell
stupid man	type=gendered reputation
stupid boy	type=gendered reputation
fucking stupid	type=reputation
bloody stupid	type=reputation
dumb fuck	type=reputation
fucking prick	type=sexist	original=sexual	anatomy=male
stupid woman	type=gendered reputation
fat arse	type=sexist	original=sexual	strength=mild
fat ass	type=sexist	original=sexual	strength=mild
lying bastard	type=reputation
lying piece of shit	type=reputation
lying scumbag	type=reputation
